{
  "name": "Default Maze",
  "width": 15,
  "height": 15,
  "playerStart": {
    "x": 1,
    "y": 1,
    "direction": 1
  },
  "exit": {
    "x": 13,
    "y": 13
  },
  "layout": [
    ["#", "#", "#", "#", "#", "#", "#", "#", "#", "#", "#", "#", "#", "#", "#"],
    ["#", " ", " ", " ", "#", " ", " ", " ", " ", " ", " ", " ", " ", " ", "#"],
    ["#", "#", "#", " ", "#", " ", "#", "#", "#", "#", "#", "#", "#", " ", "#"],
    ["#", " ", " ", " ", "#", " ", " ", " ", " ", " ", " ", " ", "#", " ", "#"],
    ["#", " ", "#", "#", "#", "#", "#", "#", "#", "#", "#", " ", "#", " ", "#"],
    ["#", " ", "#", " ", " ", " ", " ", " ", " ", " ", "#", " ", "#", " ", "#"],
    ["#", " ", "#", " ", "#", "#", "#", "#", "#", " ", "#", " ", "#", " ", "#"],
    ["#", " ", "#", " ", "#", " ", " ", " ", "#", " ", "#", " ", " ", " ", "#"],
    ["#", " ", "#", " ", "#", " ", "#", " ", "#", " ", "#", "#", "#", "#", "#"],
    ["#", " ", "#", " ", "#", " ", "#", " ", "#", " ", " ", " ", " ", " ", "#"],
    ["#", " ", "#", " ", "#", " ", "#", " ", "#", "#", "#", "#", "#", " ", "#"],
    ["#", " ", " ", " ", "#", " ", "#", " ", " ", " ", " ", " ", " ", " ", "#"],
    ["#", "#", "#", "#", "#", " ", "#", "#", "#", "#", "#", "#", "#", " ", "#"],
    ["#", " ", " ", " ", " ", " ", " ", " ", " ", " ", " ", " ", " ", " ", "#"],
    ["#", "#", "#", "#", "#", "#", "#", "#", "#", "#", "#", "#", "#", "#", "#"]
  ]
}